HHHHHHHHHH
HNNPNNPNNH
HNNNNNNNNH
HNNNNNNNNH
HNNPNNPNNH
IIIIIIIIII